11111111111111111111111111
1E00010000000C0000C0000001
10000100011100111001110001
10000100000100001001010001
10000100000100001000010001
10000100011100111000010001
100001000001DC001000010001
11000100000100001000010001
10000110011100111000010001
1P00000C00C0000000000000C1
11111111111111111111111111
