11111111111111111111111111
1000000000000C0000C0000001
10011100011100111001110001
10010100000100001001010001
10000100000100001000010001
1000010E011100111000010001
1000010000010C001000010001
10000100000100001000010001
10001110011100111000010001
1P00000C00C0000000000000C1
11111111111111111111111111