11111111111111111111111111
1E0N000000000C0000C0000N01
10011100N11100111001110001
10010100000100001001010001
10000100000100001000010001
1000010001110011100N010001
1000010000010C001000010001
10000100000100001000010001
10001110011100111000010001
1P000N0C00C00000N000000C01
11111111111111111111111111
