11111111111111111111111111
1E00010N00000C0000C0000001
10000100011100111001110001
10000100000100001001010001
10000100000100001000010001
10000100011100111000010001
1000010000010C001000010001
11000100000100001000010001
10000110011100111000010001
1P00000C00C00000N0000000C1
11111111111111111111111111
